1 2 3 4 5 6 7 8
2 0 0 0 0 0 0 7
3 0 0 0 0 0 0 6
2 0 0 0 0 0 0 5
1 0 0 0 0 0 0 4
2 0 0 0 0 0 0 3
3 0 0 0 0 0 0 2
4 0 0 0 0 0 0 1
5 0 0 0 0 0 0 2
6 0 0 0 0 0 0 3
7 8 9 8 7 6 5 4
